%%%%%%%%%%
%.      .%
%        %
%        %
%        %
%        %
%        %
%        %
%1      2%
%%%%%%%%%%