%%%%%%%%%%%%%%%%%%%%
%o... .............%
%. %. .%%%%%%. .% .%
%. %............. .%
%. .%%.%%  %%. %. .%
%......%    %......%
%. %%%.%%%%%%.%%% .%
%. .............%..%
%.  .%.   %% . .%..%
%....%...P....%...o%
%%%%%%%%%%%%%%%%%%%%