%%%%%%%%%%%%%%%%
%.....P.....%%%%
%.         .%%%%
%.         .%%%%
%.         .%%%%
%. %%%%%%  ....%
%. %%  %%     .%
%. %%  %%  ....%
%.         .%%%%
%.   ..... .%%%%
%.   .%%%. .%%%%
%.....%%%...%%%%
%%%%%%%%%%%%%%%%