%%%%%%%
%..%.P%
%.....%
%.....%
%%%%%%%
