%%%%%%%%%%%%%%%%
%           %%%%
%           %%%%
%           %%%%
% ........  %%%%
% .%%%%%%.     %
% .%%.P%%.     %
% .%%..%%.     %
% ........  %%%%
%           %%%%
%     %%%   %%%%
%     %%%   %%%%
%%%%%%%%%%%%%%%%